+--+--+--+--+--+--+--+--+--+--+--+--+--+--+--+--+--+--+--+--+--+--+--+--+--+--+--+--+--+--+--+--+--+--+--+--+--+--+--+--+
|  |     |           |                 |        |           |        |        |                                      |  |
+  +  +  +  +--+--+  +  +--+--+  +--+  +  +  +--+  +--+--+  +  +--+  +  +  +--+  +--+--+--+--+--+--+--+--+  +--+--+  +  +
|  |  |  |     |  |     |     |     |     |  |     |     |  |  |  |     |        |                    |     |     |  |  |
+  +  +  +--+  +  +--+--+  +--+--+  +--+--+--+  +--+  +  +  +  +  +--+--+--+--+--+--+--+--+--+--+--+  +  +--+  +  +  +  +
|  |  |     |     |        |     |  |           |     |  |     |     |        |           |           |  |  |  |        |
+  +  +  +--+--+  +--+  +  +  +  +  +  +--+--+--+  +--+--+--+--+  +  +  +--+  +  +  +--+  +  +--+--+  +  +  +  +--+--+  +
|  |  |           |     |  |  |     |  |           |              |     |  |     |     |     |  |     |  |  |  |     |  |
+  +  +--+--+--+--+  +--+  +  +  +--+  +  +--+--+  +  +--+--+--+--+--+--+  +--+--+--+  +--+--+  +  +--+  +  +  +  +  +  +
|  |        |        |  |  |  |  |     |  |     |     |           |     |     |        |     |        |  |     |  |  |  |
+  +--+--+  +  +--+--+  +  +  +  +  +--+  +  +  +--+--+  +--+--+  +  +  +--+  +  +--+--+--+  +  +--+--+  +--+--+  +  +--+
|     |        |     |     |  |  |  |  |  |  |           |           |        |  |           |     |     |        |     |
+--+  +--+--+--+  +  +--+--+  +--+  +  +  +--+--+  +--+--+  +--+--+--+--+--+  +  +  +--+--+  +--+  +  +--+  +--+--+--+  +
|     |     |     |        |        |              |     |        |     |     |  |  |     |  |     |           |     |  |
+  +--+  +  +  +--+--+--+  +  +--+--+--+--+--+--+--+  +  +  +--+--+  +  +--+--+  +  +  +  +--+  +--+--+--+--+--+  +  +  +
|  |     |     |     |  |  |        |           |  |  |     |        |  |        |     |        |     |           |     |
+  +--+  +--+--+  +  +  +  +--+--+  +  +--+--+  +  +  +--+--+  +--+--+  +  +--+--+  +--+--+--+  +--+  +  +--+--+--+--+  +
|        |        |     |  |     |  |  |     |  |           |     |        |        |  |     |        |        |     |  |
+--+--+--+  +--+  +--+--+  +  +  +  +  +--+  +  +--+  +--+--+--+  +--+--+--+--+--+  +  +  +  +--+--+--+--+--+  +  +  +--+
|        |     |  |        |  |     |     |        |  |        |     |           |     |  |           |     |  |  |     |
+  +--+--+  +  +  +  +--+--+--+--+  +--+  +--+--+  +--+  +--+  +--+  +  +--+--+  +  +--+  +--+--+--+  +  +  +  +  +--+  +
|           |  |  |  |           |     |     |  |  |     |  |        |  |        |  |     |        |     |  |        |  |
+  +--+--+  +  +  +  +  +  +--+  +--+  +--+  +  +  +  +--+  +--+  +--+  +  +--+--+  +  +--+  +  +  +--+--+  +--+--+--+  +
|  |     |  |  |  |  |  |  |     |  |  |     |        |           |     |     |  |  |  |     |  |  |        |        |  |
+--+  +  +--+  +  +  +--+  +  +--+  +  +  +--+--+--+  +--+--+--+--+  +--+--+  +  +  +  +  +--+  +--+  +--+--+  +--+  +  +
|     |        |  |        |  |     |  |        |     |              |  |     |     |  |  |     |     |     |     |     |
+  +--+--+--+  +--+--+--+--+  +  +  +  +--+--+  +  +--+  +--+--+--+--+  +  +--+--+--+  +--+  +  +  +--+  +  +  +  +--+  +
|  |        |  |           |  |  |     |        |  |     |        |     |  |           |     |  |  |     |     |     |  |
+  +  +--+  +--+  +  +--+--+  +  +--+--+  +--+--+  +  +--+  +  +--+  +  +  +  +--+--+--+  +--+--+  +  +--+--+--+--+  +  +
|     |  |        |  |        |  |        |        |     |  |        |     |  |  |        |        |     |        |  |  |
+  +--+  +--+--+--+  +  +--+--+  +  +--+  +--+--+--+  +  +--+  +--+--+--+--+  +  +  +  +--+  +--+--+--+  +--+--+  +  +--+
|  |        |     |     |     |  |  |     |        |  |     |  |     |        |     |     |        |        |     |     |
+  +--+  +  +  +--+--+--+  +--+  +--+  +--+  +--+  +  +--+  +  +  +  +--+--+  +  +--+--+  +--+--+  +--+--+  +  +  +--+  +
|     |  |  |           |     |        |     |  |  |  |     |  |  |           |     |  |        |        |     |     |  |
+--+  +  +  +--+--+  +--+  +  +--+  +--+  +--+  +  +  +  +--+  +  +--+--+--+--+--+  +  +--+  +  +--+--+  +--+--+--+--+  +
|  |     |  |     |        |     |  |     |     |  |  |  |  |  |     |           |     |  |  |        |  |     |        |
+  +--+--+  +  +  +--+--+--+--+  +  +  +--+  +--+  +--+  +  +  +--+  +  +--+--+  +--+  +  +  +  +--+--+  +  +  +  +--+  +
|  |     |  |  |              |     |  |        |        |  |  |     |     |     |     |  |  |  |     |     |  |     |  |
+  +  +  +  +  +--+--+--+--+  +--+--+  +  +--+  +--+--+--+  +  +  +--+  +  +--+--+  +--+  +  +--+  +  +--+--+  +--+  +  +
|     |        |                       |     |                    |     |                 |        |                 |  |
+--+--+--+--+--+--+--+--+--+--+--+--+--+--+--+--+--+--+--+--+--+--+--+--+--+--+--+--+--+--+--+--+--+--+--+--+--+--+--+--+
